 ; ; ;#;#;#;#;#;#;#
 ; ; ; ; ; ; ; ; ;#
#;#;#;#;#;#;#; ; ;#
#; ; ; ; ; ; ; ; ;#
#; ; ;#;#;#;#;#;#;#
#; ; ; ; ; ; ; ; ; 
#;#;#;#;#;#;#; ; ; 
