 ; ; ;#;#;#;#;#;#;#;#;#;#;#;#;#;#;#;#;#;#;#;#;#;#;#;#;#;#;#;#
 ; ; ; ; ; ; ; ; ;#; ; ;#; ; ; ; ; ; ; ; ; ; ; ;#; ; ; ; ; ;#
#; ; ;#; ; ;#;#;#;#; ; ;#; ; ;#;#;#;#;#;#;#; ; ;#; ; ;#;#;#;#
#; ; ;#; ; ; ; ; ;#; ; ; ; ; ; ; ; ;#; ; ; ; ; ; ; ; ; ; ; ;#
#; ; ;#;#;#;#;#;#;#; ; ;#; ; ;#;#;#;#;#;#;#;#;#;#; ; ;#;#;#;#
#; ; ; ; ; ; ; ; ; ; ; ;#; ; ;#; ; ;#; ; ;#; ; ; ; ; ;#; ; ;#
#; ; ;#;#;#;#; ; ;#;#;#;#; ; ;#; ; ;#; ; ;#;#;#;#; ; ;#; ; ;#
#; ; ;#; ; ; ; ; ; ; ; ;#; ; ;#; ; ;#; ; ; ; ; ;#; ; ; ; ; ;#
#; ; ;#; ; ;#;#;#;#;#;#;#; ; ;#; ; ;#; ; ;#; ; ;#; ; ;#;#;#;#
#; ; ;#; ; ; ; ; ; ; ; ;#; ; ; ; ; ; ; ; ;#; ; ;#; ; ;#; ; ;#
#; ; ;#;#;#;#; ; ;#;#;#;#; ; ;#;#;#;#;#;#;#;#;#;#; ; ;#; ; ;#
#; ; ; ; ; ;#; ; ;#; ; ; ; ; ; ; ; ; ; ; ; ; ; ;#; ; ;#; ; ;#
#;#;#;#;#;#;#;#;#;#; ; ;#;#;#;#; ; ;#; ; ;#;#;#;#; ; ;#; ; ;#
#; ; ; ; ; ;#; ; ; ; ; ;#; ; ; ; ; ;#; ; ;#; ; ;#; ; ;#; ; ;#
#;#;#;#; ; ;#;#;#;#;#;#;#; ; ;#;#;#;#;#;#;#; ; ;#;#;#;#; ; ;#
#; ; ; ; ; ;#; ; ;#; ; ; ; ; ; ; ; ; ; ; ; ; ; ; ; ; ;#; ; ;#
#; ; ;#;#;#;#; ; ;#;#;#;#; ; ;#;#;#;#;#;#;#;#;#;#; ; ;#; ; ;#
#; ; ;#; ; ; ; ; ; ; ; ; ; ; ; ; ; ;#; ; ; ; ; ;#; ; ; ; ; ;#
#; ; ;#; ; ;#;#;#;#; ; ;#;#;#;#; ; ;#; ; ;#;#;#;#; ; ;#; ; ;#
#; ; ; ; ; ;# ; ;; ; ; ;#; ; ; ; ; ; ; ; ; ; ; ;#; ; ;#; ; ; 
#;#;#;#;#;#;#;#;#;#;#;#;#;#;#;#;#;#;#;#;#;#;#;#;#;#;#;#; ; ; 
