 ; ; ;#;#;#;#;#;#;#
 ; ; ; ; ; ;#; ; ;#
#;#;#;#; ; ;#; ; ;#
#; ; ; ; ; ; ; ; ;#
#; ; ;#;#;#;#; ; ;#
#; ; ;#; ; ; ; ; ; 
#;#;#;#;#;#;#; ; ; 